---
typora-copy-images-to: ../../assets/img/git-basico/
typora-root-url: ../../
layout: post
categories: tema1 git AQUI
conToc: true
title : Git AQUI
permalink: git-basico AQUI
subtitle: Comandos Git Básicos
author:
- Víctor Ponz YO
lang: es
titlepage: true
titlepage-background: assets/img/git-basico/dibujo.png
page-background: assets/img/fondo-pagina.png
urlcolor: CornflowerBlue
linkcolor: black
toc-own-page: true
toc-title: Contenidos
header-left: UD 1. Git
header-right: Ciberseguridad
footer-left: IES El Caminàs
footer-right: \thepage/\pageref{LastPage}
titlepage-rule-color: 1e2c37
header-includes: |
    \usepackage{lastpage} 
    \usepackage{awesomebox}
pandoc-latex-environment:
    noteblock: [note]
    tipblock: [tip]
    warningblock: [warning]
    cautionblock: [caution]
    importantblock: [important]
---